0
50 28
5 5 5 5 5 5 5 5 5 9 3 1 1 3 1 1 1 1 1 1 1 1 1 39 1 32 34 34 34 34 34 34 34 34 34 34 34 34 34 34 34 34 34 34 34 34 34 34 34 34 
5 5 5 5 5 5 5 5 5 14 1 1 1 1 1 1 1 1 1 1 3 1 1 39 26 34 34 34 34 34 34 34 34 34 34 35 34 34 34 34 34 34 34 34 34 35 34 34 34 34 
5 5 5 5 5 5 5 5 5 14 1 1 3 3 1 1 1 1 1 1 1 1 1 39 32 34 34 34 34 34 34 35 34 34 34 34 34 34 34 34 34 34 34 34 34 34 34 34 34 31 
5 5 5 5 5 5 5 5 5 5 9 1 1 1 1 1 1 1 37 1 1 1 1 39 32 34 34 34 34 34 34 34 34 34 34 34 35 34 34 34 34 34 35 34 34 34 34 34 33 1 
5 5 5 5 5 5 5 5 5 5 14 1 3 1 3 1 1 1 1 1 1 1 1 39 29 30 30 34 34 34 34 34 34 34 34 34 34 34 34 34 34 34 34 34 34 34 34 30 31 1 
5 5 5 5 5 5 5 5 5 5 14 1 1 1 3 1 1 1 1 1 3 1 1 39 1 1 1 29 30 30 34 34 34 34 34 34 34 34 34 34 34 34 34 34 34 34 31 1 1 1 
5 5 5 5 5 5 5 5 5 5 14 1 3 1 3 1 1 1 1 1 1 1 1 39 1 1 1 1 1 1 29 30 30 34 34 34 34 34 34 34 34 34 34 35 34 33 1 1 1 1 
5 5 5 5 5 5 5 5 5 5 14 1 1 3 3 1 1 1 1 1 1 1 1 39 38 38 38 38 38 38 1 1 1 29 30 30 34 34 34 34 34 34 34 34 34 33 1 1 1 1 
5 5 5 5 5 5 5 5 5 5 14 1 1 1 1 3 1 37 1 1 1 1 1 1 1 1 1 1 1 1 1 1 1 1 1 1 29 30 30 30 30 30 30 30 30 31 1 38 38 38 
5 5 5 5 5 5 5 5 5 5 5 9 1 1 1 1 3 1 1 1 1 1 1 1 1 1 1 1 1 1 1 1 1 1 1 1 1 1 1 1 1 1 1 1 1 1 1 1 1 1 
5 5 5 5 5 5 5 5 5 5 5 5 9 1 1 1 3 1 1 1 1 1 1 1 37 1 1 1 1 1 1 1 1 1 1 1 1 1 1 1 1 1 1 1 1 1 1 1 1 1 
5 5 5 5 5 5 5 5 5 5 5 5 5 9 1 3 1 1 1 1 1 37 1 1 1 1 1 1 1 1 1 1 1 1 1 1 1 1 1 1 1 1 1 1 1 1 1 1 1 1 
5 5 5 5 5 5 5 5 5 5 5 5 5 14 1 1 1 3 1 1 1 1 1 1 1 1 1 1 1 1 1 1 1 1 1 1 1 1 1 1 1 1 1 1 1 1 1 1 1 1 
10 5 5 5 5 5 5 5 5 5 5 5 5 14 1 1 3 3 1 1 1 1 1 1 1 1 1 1 1 1 1 1 1 1 1 1 1 1 1 1 1 1 1 1 1 1 1 1 1 1 
1 10 11 11 5 5 5 5 5 5 5 5 5 14 1 1 1 1 1 1 1 1 1 1 1 1 1 1 1 1 1 1 1 1 1 1 1 1 1 1 1 1 1 1 1 1 1 1 1 1 
3 3 1 1 10 5 5 5 5 5 5 5 5 5 9 1 1 1 3 1 1 1 1 1 1 1 1 1 1 1 1 1 1 1 1 1 1 1 1 1 1 1 1 1 1 1 1 1 1 1 
1 3 3 1 1 10 5 5 5 5 5 5 5 5 5 8 9 1 1 1 37 1 1 1 1 1 1 1 1 1 1 1 1 1 1 1 1 1 1 1 1 1 1 1 1 1 1 1 1 1 
1 1 1 3 1 1 13 5 5 5 5 5 5 5 5 5 5 9 1 3 3 1 1 1 1 1 1 1 1 1 1 1 1 1 1 1 1 1 1 1 1 1 1 1 1 1 1 1 1 1 
1 1 3 1 3 1 13 5 5 5 5 5 5 5 5 5 5 14 1 3 1 1 3 1 3 3 1 1 1 1 1 1 1 1 1 1 1 1 1 1 1 1 1 1 1 1 1 1 1 1 
1 1 1 1 3 3 10 11 11 5 5 5 5 5 5 5 5 5 9 1 1 1 1 1 1 1 1 7 8 8 8 9 1 1 1 1 1 1 1 1 1 1 1 1 1 1 1 1 1 1 
1 3 1 1 1 1 1 1 1 10 5 5 5 5 5 5 5 5 5 8 8 8 9 1 1 1 7 5 5 5 5 5 9 1 1 1 1 1 1 1 1 1 1 1 1 1 1 1 1 1 
1 1 1 3 1 3 1 3 1 1 10 5 5 5 5 5 5 5 5 5 5 5 5 8 8 8 5 5 5 5 5 5 14 1 1 1 1 1 1 1 1 1 1 1 1 1 1 36 1 1 
1 3 1 1 1 3 1 3 3 3 3 10 11 5 5 5 5 5 5 5 5 5 5 5 5 5 5 5 5 5 5 5 12 1 1 1 1 1 1 1 1 1 1 1 1 36 36 1 1 1 
1 1 1 1 3 3 3 1 1 1 3 1 1 10 5 5 5 5 5 5 5 5 5 5 5 5 5 5 5 11 11 12 1 1 1 1 1 1 1 1 1 1 1 1 1 1 1 37 36 36 
1 1 1 1 1 1 1 1 1 1 1 3 1 1 10 5 5 5 5 5 5 5 5 5 5 5 11 11 12 1 1 1 1 3 1 1 1 1 1 1 37 1 1 1 1 1 36 1 1 1 
1 1 1 1 1 1 1 1 1 1 1 1 3 3 1 10 11 11 11 5 5 5 5 5 5 12 1 1 1 1 1 3 1 1 1 1 1 1 1 1 1 1 36 1 36 37 1 1 36 1 
1 1 1 1 1 1 1 1 1 1 1 1 1 1 3 1 1 1 1 10 11 11 11 11 12 1 1 3 1 1 1 1 1 1 1 1 1 1 1 1 1 1 1 1 36 1 36 36 1 1 
1 1 1 1 1 1 1 1 1 1 1 1 1 1 1 1 1 3 1 3 1 1 1 1 1 1 1 1 1 1 1 1 1 1 1 1 1 1 1 1 1 1 1 1 1 36 1 1 1 1