50 28
5 5 6 6 6 6 9 1 38 38 38 38 38 38 36 36 36 36 36 36 36 36 36 36 36 38 38 38 38 38 38 38 38 1 51 53 36 36 36 55 1 38 38 38 38 38 38 36 36 36 
5 5 6 6 6 6 14 1 36 1 1 1 1 1 26 28 1 1 36 36 36 36 2 1 1 1 1 1 7 8 9 2 2 2 41 41 2 55 2 42 1 1 26 27 27 28 1 1 36 36 
6 6 5 5 5 5 12 1 1 1 1 7 9 1 32 34 27 28 1 36 36 36 1 1 3 1 1 7 5 5 5 8 9 1 48 45 56 57 56 2 1 26 34 34 34 33 1 1 1 36 
6 6 5 6 5 14 1 1 1 1 7 5 14 1 32 35 34 33 1 1 36 1 1 3 7 8 8 6 5 5 5 6 12 1 1 48 45 47 58 1 1 32 34 35 34 34 28 1 1 40 
10 11 6 5 6 6 8 9 1 7 6 5 6 9 29 34 34 33 1 3 1 1 3 1 10 5 5 5 5 5 6 6 2 1 1 1 48 50 1 1 26 34 34 34 34 34 33 3 1 40 
55 1 13 5 5 5 5 14 1 13 5 5 6 12 1 32 34 35 28 1 1 1 1 1 7 5 5 5 5 5 6 14 1 1 1 1 1 1 3 1 32 34 35 34 34 34 31 1 1 40 
36 55 10 11 11 5 5 5 8 5 6 5 14 1 1 32 34 34 33 3 3 1 1 3 13 5 5 5 5 5 6 12 1 1 1 37 1 1 1 1 32 34 34 34 34 33 1 1 1 40 
36 42 2 1 1 10 5 5 5 5 5 6 14 1 26 35 34 34 33 1 1 1 1 1 10 6 5 5 5 5 14 1 1 1 3 1 1 1 40 1 29 34 34 34 34 31 1 3 1 40 
2 42 37 1 2 1 13 6 5 6 5 5 5 9 29 30 30 30 31 1 3 36 1 1 1 10 5 5 5 5 14 1 1 1 1 1 3 1 40 26 27 34 34 34 33 1 1 1 3 40 
47 47 37 1 1 7 5 5 5 5 6 5 5 5 8 8 9 1 1 36 36 36 1 3 1 2 13 5 5 5 6 9 1 1 1 1 3 1 40 29 30 34 34 35 34 28 1 1 1 40 
49 50 7 8 8 5 5 11 5 5 5 5 6 6 5 5 14 1 1 3 36 3 1 1 1 7 5 5 5 5 5 6 8 9 1 1 1 37 1 1 2 29 30 30 34 34 31 1 1 53 
36 7 6 5 5 11 12 1 10 11 5 5 5 5 5 5 14 1 1 1 1 1 1 1 7 5 5 5 5 5 5 5 5 5 9 1 1 1 2 1 1 1 1 53 65 34 28 28 53 1 
37 13 5 5 14 1 1 1 1 1 10 5 5 5 5 6 5 9 1 1 1 1 1 7 5 5 5 5 5 5 5 5 5 5 5 9 1 1 1 1 1 1 53 4 4 65 34 63 54 54 
37 10 11 11 12 1 1 1 1 1 1 10 11 11 11 5 5 5 8 9 7 8 8 5 5 5 5 5 5 5 5 5 5 5 5 14 1 1 1 1 1 1 41 41 4 1 64 1 36 36 
4 36 1 1 1 1 1 3 1 1 1 1 1 1 1 10 5 5 5 6 5 5 5 5 5 5 5 5 5 5 5 5 6 5 5 12 1 1 1 1 3 1 48 45 46 46 46 56 36 36 
1 1 1 1 1 1 37 3 37 1 1 1 1 1 1 1 10 11 5 5 5 5 5 5 5 5 5 5 5 5 5 5 6 5 5 9 1 1 1 1 3 1 1 48 49 49 49 41 2 2 
1 39 1 3 1 1 3 3 3 1 1 1 1 1 3 1 1 1 10 5 5 5 5 5 5 5 5 5 5 5 6 5 5 5 5 5 9 1 1 1 2 1 1 1 1 1 37 45 46 47 
1 39 1 3 1 1 1 1 1 1 1 1 1 1 1 1 1 1 1 10 6 6 5 5 5 5 5 5 5 5 5 5 5 6 5 5 5 8 8 9 1 2 1 1 1 3 2 48 49 50 
1 39 1 1 1 1 1 1 1 1 3 1 1 1 1 1 3 1 1 1 13 6 5 6 5 5 5 5 5 5 5 5 5 5 5 5 5 5 5 5 8 9 1 1 1 2 2 1 1 1 
38 38 1 1 1 1 3 1 1 1 38 38 38 38 38 1 1 1 1 1 13 6 5 5 5 5 5 5 5 5 5 5 5 5 5 5 5 5 5 5 5 5 9 1 1 3 2 1 3 1 
2 37 1 3 3 1 2 2 2 2 3 1 1 2 40 1 1 1 1 1 10 6 6 5 5 5 5 5 5 5 5 5 5 6 5 5 5 5 5 5 5 5 14 1 1 1 2 1 3 3 
1 37 1 1 1 26 27 28 3 26 27 27 28 3 40 1 1 1 1 1 1 10 6 6 5 5 5 5 5 5 5 5 5 11 12 10 11 5 5 5 5 5 14 1 1 1 3 1 1 1 
1 37 1 1 26 34 34 34 27 34 34 34 34 28 40 2 3 1 1 3 1 1 13 6 6 5 5 5 5 5 5 5 12 1 1 1 1 10 5 5 5 5 5 9 1 1 1 1 2 2 
1 1 1 1 32 34 34 35 34 34 34 35 34 33 2 2 1 1 1 1 1 1 10 6 6 5 5 5 5 5 5 12 1 1 1 1 1 1 10 5 5 5 5 5 5 9 2 2 2 2 
37 1 3 1 29 34 34 34 34 34 34 30 30 31 40 1 4 37 1 1 3 1 1 13 6 6 6 6 6 11 12 1 1 1 1 1 1 1 1 10 5 5 5 5 5 5 8 8 9 7 
1 1 1 1 2 32 34 34 34 30 31 2 1 1 4 1 1 1 1 1 1 1 1 10 11 12 10 11 12 1 1 3 1 3 1 37 4 1 1 1 10 11 5 5 5 5 5 5 5 5 
55 1 1 1 1 29 30 30 31 2 1 1 4 1 2 1 4 1 1 1 1 3 1 1 1 1 1 1 1 1 1 1 1 1 1 4 4 4 2 1 1 1 10 5 5 5 5 5 5 5 
1 55 1 1 1 1 1 1 1 38 38 38 38 38 38 38 38 38 38 38 38 38 38 38 38 38 38 38 38 38 38 38 38 38 38 38 38 38 38 38 2 1 2 10 5 5 5 5 5 5