20 15
1 38 1 1 1 4 1 1 1 1 1 3 1 1 1 1 1 1 1 1 
8 8 9 37 1 1 1 1 36 1 1 1 1 1 26 28 1 1 36 1 
11 5 5 8 8 9 1 1 1 1 1 7 9 1 32 34 27 28 1 1 
1 10 5 6 5 14 1 1 3 1 7 5 14 1 32 35 34 33 1 1 
1 1 13 5 6 6 8 9 1 7 6 5 6 9 29 34 34 31 1 1 
1 1 13 5 5 5 5 14 1 13 5 5 6 12 1 32 33 1 1 1 
1 1 10 11 11 5 5 5 8 5 6 5 14 40 1 32 33 1 1 3 
1 3 1 1 1 10 5 5 5 5 5 6 14 1 26 35 33 1 1 1 
2 1 2 1 37 1 13 6 5 6 5 5 5 9 29 30 31 1 1 1 
1 1 1 1 1 7 5 5 5 5 6 5 5 5 8 8 9 1 1 36 
1 39 7 8 8 5 5 11 5 5 5 5 6 6 5 5 14 1 1 1 
1 7 6 5 5 11 12 1 10 11 5 5 5 5 5 5 14 1 3 2 
1 13 5 5 14 1 1 1 1 1 10 5 5 5 5 6 5 9 38 1 
1 10 11 11 12 1 36 1 2 1 3 51 3 1 1 5 5 5 8 9 
4 1 1 1 1 1 1 1 1 1 25 23 1 1 3 1 5 11 11 11