1
50 28
18 18 18 18 18 18 18 18 40 13 13 13 23 24 24 24 24 24 24 24 24 24 24 24 24 25 13 13 13 13 13 12 13 38 18 18 18 18 18 18 18 18 18 40 13 13 13 13 13 13 
18 18 18 18 18 18 19 18 42 13 13 13 30 26 26 26 26 26 26 26 26 26 26 26 26 34 13 15 13 13 38 39 39 18 18 18 18 18 18 18 18 18 18 39 39 39 40 13 14 13 
18 18 18 17 18 18 18 18 35 13 13 13 13 30 31 31 26 26 26 26 26 26 26 26 31 32 13 13 13 38 18 18 18 18 18 18 18 18 18 18 18 18 18 18 18 18 35 13 12 13 
18 17 18 18 18 18 18 42 13 13 13 15 12 12 12 13 30 26 26 26 26 26 26 32 12 15 13 13 13 41 18 18 18 18 18 18 18 18 17 17 18 18 18 18 18 35 13 13 12 14 
18 18 18 18 19 18 18 42 13 13 15 13 16 13 13 13 13 30 32 30 31 31 32 12 12 13 13 13 13 37 18 18 18 18 18 18 18 18 18 18 18 18 18 18 42 13 13 14 12 12 
37 18 18 18 18 18 17 18 40 13 13 13 12 12 15 13 13 12 15 12 13 13 13 13 13 13 15 13 13 13 41 18 18 18 18 18 18 18 18 18 18 18 18 18 18 40 13 13 12 12 
13 37 18 18 18 18 18 18 18 40 13 13 13 12 12 12 12 12 12 14 13 13 16 13 13 13 13 13 13 38 18 18 18 17 18 18 18 18 17 18 18 18 18 18 18 42 13 13 12 12 
13 13 36 36 37 18 18 18 18 18 40 13 13 16 12 12 13 13 12 12 13 13 13 13 13 38 40 13 38 18 18 18 18 18 18 18 18 18 18 18 18 18 18 18 35 36 13 13 12 12 
13 13 13 13 13 37 18 19 18 18 42 13 13 13 12 13 38 39 40 12 13 13 13 38 39 18 18 39 18 18 18 18 18 18 18 17 18 18 18 18 18 18 18 18 40 13 13 15 16 12 
13 13 13 13 13 13 41 18 18 18 18 40 13 13 38 39 18 18 18 40 13 13 38 18 18 18 19 18 18 18 18 18 18 18 18 18 18 18 18 18 18 18 18 18 42 16 12 15 12 12 
13 13 13 13 13 13 37 18 18 18 18 18 40 38 18 18 18 18 18 18 39 39 17 18 18 18 18 18 18 18 18 18 35 37 18 18 18 18 18 18 18 18 18 18 35 15 15 13 16 16 
13 13 13 13 13 13 13 36 37 18 18 18 18 18 18 18 18 18 18 18 18 18 18 18 18 18 18 17 18 18 18 35 13 13 37 18 18 18 18 18 19 18 18 42 13 12 13 16 15 13 
13 13 16 13 13 13 13 12 38 18 18 18 18 18 18 18 18 18 18 18 18 18 18 18 18 18 18 18 35 36 36 13 13 13 13 36 36 37 18 18 19 18 18 42 13 12 12 12 12 13 
14 13 13 12 13 15 13 12 41 18 18 17 18 18 18 18 18 18 18 18 18 18 18 17 18 18 18 35 14 13 13 13 13 13 13 13 13 13 41 18 18 18 18 35 13 13 16 15 13 16 
13 12 16 15 15 15 13 13 41 18 18 18 18 18 18 18 18 18 18 18 18 18 18 18 18 35 36 13 13 13 13 13 13 16 13 13 13 13 41 18 18 18 18 40 13 13 13 13 13 13 
13 12 12 15 15 12 13 13 37 18 18 18 18 18 18 18 18 18 18 18 18 18 18 18 35 13 13 13 13 13 14 15 13 15 13 13 13 38 18 18 18 18 18 18 40 16 13 13 16 13 
13 13 15 12 13 12 14 13 13 37 18 18 18 18 18 18 18 18 18 18 18 18 18 42 13 15 13 13 13 13 13 13 13 13 13 38 39 18 18 18 18 18 18 18 18 40 13 13 13 13 
13 13 12 12 13 13 16 13 13 13 41 18 18 18 18 18 18 18 18 18 18 18 18 42 13 13 13 13 15 12 13 13 15 13 13 37 18 18 18 18 18 18 18 18 18 42 13 13 13 13 
13 13 16 16 13 12 12 13 13 38 18 18 18 18 18 18 18 18 18 18 18 18 18 42 13 13 13 16 12 13 13 13 13 13 13 13 37 18 18 18 18 18 18 18 18 42 13 13 13 13 
13 16 12 12 12 12 13 38 39 18 18 18 18 19 18 18 18 18 19 18 18 18 18 35 13 12 12 12 12 12 15 13 13 13 13 13 13 37 18 18 18 18 18 18 18 18 40 13 13 13 
12 12 12 16 12 13 13 41 18 18 18 18 18 18 18 18 18 17 18 18 18 18 35 13 12 15 13 13 13 13 13 13 13 13 16 13 13 13 41 18 17 18 18 18 18 18 18 39 40 13 
12 12 12 13 13 13 38 18 19 18 18 18 18 18 18 18 18 18 18 18 18 35 13 13 12 12 13 13 13 13 23 25 13 13 13 15 13 13 41 18 18 18 18 18 18 18 18 18 18 40 
12 12 12 13 13 13 41 18 18 18 18 18 18 18 18 18 18 18 18 18 42 13 15 13 15 12 12 23 24 24 26 26 24 25 13 13 13 13 37 18 18 18 18 18 18 18 19 17 18 18 
12 12 12 13 13 13 41 18 18 18 18 18 18 18 18 18 18 18 18 18 42 13 13 12 12 13 13 33 26 26 26 26 26 26 25 13 13 15 13 37 18 18 18 18 18 18 18 18 18 18 
12 12 12 13 13 13 37 18 18 18 18 18 18 18 18 18 18 18 18 18 35 13 13 13 12 23 24 26 26 26 26 26 26 26 26 25 13 13 13 13 37 18 18 35 36 37 18 18 18 18 
12 12 16 12 12 12 13 36 36 36 37 18 18 35 36 37 18 18 18 35 13 13 12 23 24 26 26 26 26 26 26 26 26 26 26 26 24 24 25 13 13 37 35 13 12 13 41 18 18 18 
12 12 12 12 13 12 12 13 13 13 13 36 36 13 13 13 37 18 35 13 13 12 23 26 26 26 26 26 26 26 26 26 26 26 26 26 26 26 26 25 12 12 12 12 12 38 18 18 18 18 
12 12 12 14 12 13 12 12 12 13 13 13 13 13 13 13 13 36 13 13 13 13 30 26 26 26 26 26 26 26 26 26 26 26 26 26 26 26 26 32 16 13 12 13 13 41 18 18 18 18