50 28
1 1 1 1 1 1 1 1 1 1 1 1 1 1 1 1 10 6 5 6 5 12 2 2 2 2 1 1 1 1 1 2 1 1 1 1 13 5 5 5 12 1 1 1 1 1 1 1 1 1 
1 1 1 1 1 1 1 1 1 1 1 1 1 1 1 1 2 13 5 5 14 2 2 1 1 1 1 1 1 1 2 2 2 1 1 7 5 5 5 14 2 2 1 1 1 1 1 1 1 1 
1 1 1 1 1 1 1 1 1 1 1 1 1 1 2 2 7 5 5 5 14 2 2 1 1 1 1 1 1 1 1 2 1 1 7 5 5 5 5 14 1 1 1 1 1 1 1 1 1 1 
1 1 1 1 1 1 1 1 1 1 1 1 1 2 7 6 5 5 5 11 12 2 1 1 1 1 1 1 1 1 1 7 8 8 5 5 5 5 5 5 9 1 1 1 1 1 1 1 1 1 
1 1 1 1 1 1 1 1 1 1 2 2 2 7 6 6 5 5 12 2 2 2 1 1 1 2 1 1 1 1 7 5 5 5 5 5 5 5 5 5 5 9 1 1 1 1 1 1 1 1 
1 1 1 1 1 1 1 1 1 2 7 8 8 6 5 5 5 14 2 2 2 1 1 1 1 2 1 1 1 2 13 5 5 5 5 5 5 5 5 5 5 14 1 1 1 1 1 1 1 1 
2 1 1 1 1 1 1 1 7 8 6 5 5 5 5 5 5 6 9 2 2 1 1 1 1 1 1 1 1 7 6 5 5 5 5 5 5 5 5 5 5 5 9 1 1 1 1 1 1 1 
9 1 1 1 1 1 1 1 13 5 5 5 5 5 5 5 5 5 6 8 9 1 1 1 2 1 1 1 1 13 6 5 5 5 5 5 5 5 5 5 5 5 14 1 1 1 1 1 1 1 
6 1 1 1 1 1 2 7 5 5 5 5 5 5 5 5 5 5 5 6 12 1 2 1 1 1 1 1 1 10 6 5 5 5 5 5 5 5 5 5 5 5 12 1 1 1 1 1 2 2 
5 14 1 1 1 1 2 13 5 5 5 5 5 5 5 5 5 5 5 14 2 2 1 1 1 1 1 1 1 2 10 6 5 5 5 5 5 6 5 5 6 5 9 7 8 9 1 1 7 8 
5 6 9 2 1 2 2 13 5 5 5 5 5 5 5 5 5 6 5 14 2 1 1 1 1 1 1 1 1 2 2 13 5 5 5 5 5 5 5 5 5 5 5 5 5 5 8 8 6 5 
5 5 6 8 9 2 7 5 5 5 5 5 5 5 5 5 5 6 6 12 2 1 1 1 1 1 1 1 1 2 7 5 5 6 5 5 5 5 11 11 12 10 5 5 5 5 5 5 5 5 
5 5 5 6 5 5 5 5 5 5 6 5 5 5 5 5 5 6 14 2 1 1 1 1 1 1 1 1 1 7 5 5 6 12 10 11 11 12 1 1 1 1 10 11 11 5 5 5 5 5 
5 11 5 5 5 5 5 6 12 2 10 6 5 5 5 5 5 6 14 2 1 1 2 1 1 1 1 1 2 13 5 6 14 1 1 1 1 1 1 1 1 1 1 2 2 10 5 5 5 5 
12 2 10 11 6 6 6 12 2 2 2 13 6 6 6 6 5 5 6 9 2 1 1 1 1 7 8 9 7 5 5 6 12 1 1 1 1 1 1 1 1 1 1 1 1 1 10 11 5 5 
1 2 2 2 10 11 12 2 2 2 2 10 11 11 6 6 6 5 5 6 8 9 2 7 8 5 5 5 6 5 6 6 9 1 1 1 1 1 1 1 1 1 1 1 1 1 1 1 10 5 
1 1 2 2 2 2 2 2 2 1 2 2 2 2 10 11 12 10 5 5 5 14 7 6 5 5 5 5 5 5 5 6 14 2 1 1 1 1 1 1 1 1 1 1 1 1 1 1 1 10 
1 1 1 1 1 1 1 1 1 1 1 2 2 2 2 2 2 2 13 5 5 5 5 5 5 6 6 5 5 5 5 6 6 9 1 1 1 1 1 1 1 1 1 1 1 1 1 1 1 2 
1 1 1 1 1 1 1 1 1 1 1 1 1 1 1 2 2 2 10 11 5 5 5 5 5 5 5 5 5 5 5 5 6 6 9 1 1 1 1 1 1 1 1 1 1 1 1 1 1 1 
1 1 1 1 1 1 1 1 1 1 1 1 1 1 1 1 1 1 2 2 10 11 6 5 5 5 5 5 5 5 5 5 5 6 14 1 2 1 1 1 1 1 1 1 1 1 1 1 1 1 
1 1 1 1 1 1 1 1 1 1 1 1 1 1 1 1 1 1 1 1 2 2 10 6 6 5 5 5 5 5 5 5 5 5 5 9 1 1 1 1 1 1 1 1 1 1 1 1 1 1 
1 1 1 1 1 2 1 1 1 1 1 1 1 1 1 1 1 1 1 1 1 2 2 13 6 5 5 5 5 5 5 5 6 5 5 12 1 1 1 1 1 1 1 1 1 1 1 1 1 1 
1 1 1 1 1 1 1 1 1 1 1 1 1 1 1 1 1 1 1 1 1 1 7 5 5 5 5 5 5 5 5 5 5 6 6 9 1 1 1 1 1 1 1 1 1 1 1 1 1 1 
1 1 1 1 1 1 1 1 1 1 1 1 1 1 1 1 1 1 1 7 8 8 6 5 5 5 5 5 5 5 5 11 11 11 6 6 8 8 9 1 1 1 1 1 1 1 1 1 1 1 
1 1 1 1 1 1 1 1 1 1 1 1 1 1 1 1 1 1 7 6 6 6 11 11 6 6 6 6 6 6 12 1 1 1 10 6 6 6 6 9 1 1 1 1 1 1 1 1 1 1 
1 1 1 1 1 1 1 1 1 1 2 2 1 1 7 9 7 8 6 6 6 12 1 1 10 11 12 10 11 12 1 1 1 1 1 10 6 6 6 14 1 1 1 1 1 1 1 1 1 1 
1 1 1 1 1 1 1 1 1 1 1 1 1 7 6 6 6 6 6 11 12 1 1 1 1 1 1 1 1 1 1 1 1 1 1 1 13 6 6 6 9 1 1 1 1 1 1 1 1 1 
1 1 1 1 1 1 1 2 2 1 7 8 8 6 6 6 6 6 12 1 1 1 1 1 1 1 1 1 1 1 1 1 1 1 1 1 13 6 6 6 6 8 8 9 1 1 1 1 1 1