0
50 28
5 5 5 5 5 5 5 5 5 5 5 5 5 5 5 5 5 5 9 1 26 34 35 34 34 34 34 34 34 34 28 1 3 1 1 7 6 6 6 6 5 5 5 6 6 6 6 6 6 6 
5 5 5 5 5 5 5 5 5 5 5 5 5 5 5 5 6 6 12 1 32 34 34 34 34 34 34 34 34 34 34 28 1 3 1 10 5 5 6 5 5 5 5 5 5 5 5 6 6 6 
5 5 5 5 5 5 5 5 5 5 5 5 5 5 5 5 5 14 1 26 34 34 34 34 34 34 34 35 34 34 34 33 1 3 1 1 10 5 6 5 5 5 5 5 5 5 5 5 6 6 
6 5 5 5 5 5 5 5 5 5 5 5 5 5 5 5 6 14 26 34 34 34 34 35 34 34 34 34 34 34 34 34 28 1 1 1 7 6 6 5 5 5 5 5 5 5 5 5 6 6 
10 6 5 5 5 5 5 5 5 5 5 5 5 5 5 5 6 12 29 34 34 34 34 34 34 34 34 34 34 34 34 34 31 2 7 8 6 5 5 5 5 5 6 6 5 5 5 5 6 6 
1 10 11 11 5 5 5 5 5 5 5 11 11 11 5 5 5 8 9 29 34 34 34 34 34 34 34 30 30 34 34 31 2 7 6 6 5 5 5 5 5 6 6 6 6 6 6 6 11 5 
1 1 1 3 10 11 6 6 6 6 12 1 1 1 10 6 5 5 5 9 29 34 34 30 31 29 31 36 1 29 31 2 7 6 6 5 5 5 5 6 6 6 6 6 6 6 11 12 1 10 
3 1 3 1 1 1 10 11 11 12 1 1 1 1 1 13 5 5 5 5 9 29 31 1 1 1 1 2 36 1 1 7 6 6 5 5 5 6 6 11 12 10 6 6 6 12 1 1 3 1 
28 1 1 1 1 1 1 1 1 1 1 26 27 27 28 10 5 5 5 5 5 9 1 1 7 8 9 1 1 1 7 6 5 5 6 6 6 6 12 1 1 1 10 11 12 1 3 1 1 2 
34 28 1 26 28 3 1 1 1 26 27 34 34 34 34 28 10 5 6 6 5 6 8 8 6 6 6 9 7 8 6 5 5 6 6 5 6 12 26 27 27 28 1 1 1 1 1 26 27 28 
34 34 27 34 34 28 1 1 26 34 34 34 35 34 34 34 28 10 5 5 5 6 6 6 6 5 5 11 5 5 5 5 6 6 5 5 12 26 34 34 34 34 27 27 28 1 26 34 34 34 
34 34 34 34 34 34 27 27 34 34 34 34 34 34 34 34 34 28 10 6 6 5 5 5 11 11 12 1 13 5 5 6 6 5 5 12 26 34 34 34 34 34 34 34 34 27 34 34 34 34 
34 34 34 35 34 34 34 34 35 34 34 34 34 34 34 34 34 31 1 13 5 5 5 12 1 1 1 1 10 5 5 6 6 5 12 26 34 34 34 34 34 35 34 34 34 34 34 34 34 34 
34 34 34 34 34 34 34 34 34 34 34 34 34 34 34 34 31 1 1 10 5 5 14 1 1 1 1 3 1 10 5 6 6 5 9 29 34 34 34 34 34 34 34 34 34 35 34 34 34 34 
34 34 34 34 34 34 34 34 34 34 34 35 34 34 34 33 1 2 1 7 5 5 14 1 1 3 1 37 1 1 13 6 6 5 12 3 32 34 34 34 34 34 35 34 34 34 34 34 34 34 
34 34 34 34 34 30 30 34 34 34 34 34 34 34 34 33 1 2 7 6 5 5 14 1 1 1 3 1 37 1 13 6 6 14 3 26 34 34 34 34 34 34 34 34 34 34 34 34 34 34 
34 34 30 30 31 1 1 29 34 34 34 34 34 34 34 34 28 1 13 6 5 5 6 9 1 1 1 1 1 7 5 5 5 14 3 32 34 34 34 34 34 34 34 34 34 34 35 34 34 34 
30 31 1 4 1 4 1 1 29 30 34 34 34 34 34 34 31 7 6 6 6 6 6 6 9 1 1 1 7 6 6 5 5 6 9 29 34 34 34 34 35 34 34 34 34 34 34 34 30 31 
1 1 1 1 1 1 1 1 1 1 29 34 34 34 34 31 7 6 6 6 6 6 6 6 6 8 8 8 6 6 6 5 5 6 6 9 29 34 34 34 34 34 31 29 34 34 34 31 1 1 
8 9 1 1 1 1 1 4 1 1 1 29 30 30 31 7 6 6 6 6 6 6 6 6 11 11 12 1 10 11 6 6 6 6 6 6 9 29 34 34 30 31 1 1 29 30 31 1 3 1 
5 5 9 1 7 8 8 9 1 1 1 1 1 1 7 6 6 6 6 6 6 11 11 12 2 2 2 36 1 1 10 6 6 6 6 6 6 9 29 31 3 1 3 1 1 1 1 1 1 7 
5 5 5 8 5 5 5 5 9 1 1 7 8 8 5 6 6 6 5 6 12 26 27 27 28 1 2 2 26 27 28 10 5 6 6 6 6 6 8 9 7 9 1 1 7 8 9 4 7 5 
5 5 5 5 5 5 5 5 5 8 8 5 5 5 5 5 5 5 5 12 26 34 34 34 34 27 27 27 34 34 34 28 10 6 5 5 6 5 5 5 5 5 8 8 5 5 5 8 5 5 
5 5 5 5 5 5 5 5 5 5 5 5 5 5 5 5 5 5 12 26 34 34 34 34 34 34 34 34 35 34 34 34 28 10 5 5 5 5 5 5 5 5 5 5 5 5 5 5 5 5 
5 5 5 5 5 5 5 5 5 5 5 5 5 5 5 5 5 12 26 34 34 34 34 34 34 34 34 34 34 34 34 34 34 28 10 11 5 5 5 5 5 5 5 5 5 5 5 5 5 5 
5 5 5 5 5 5 5 5 5 5 5 5 5 5 5 5 5 9 29 30 34 34 34 34 35 34 34 34 34 34 34 34 34 31 1 1 10 5 5 5 5 5 5 5 5 5 5 5 5 5 
5 5 5 5 5 5 5 5 5 5 5 5 5 5 5 5 5 14 1 1 29 34 34 34 34 34 34 35 34 34 34 34 33 1 1 1 1 13 5 5 5 5 5 5 5 5 5 5 5 5 
5 5 5 5 5 5 5 5 5 5 5 5 5 5 5 5 5 12 1 1 1 32 34 34 34 34 34 34 34 34 34 34 31 1 1 1 7 5 5 5 5 5 5 5 5 5 5 5 5 5
