2
50 28
11 11 11 11 11 11 11 11 11 11 11 11 11 11 11 11 11 11 11 11 11 11 11 11 11 11 11 11 11 11 11 11 11 11 11 11 11 11 11 11 11 11 1 9 9 9 9 9 9 9 
11 11 11 11 11 11 11 11 11 11 11 11 11 11 11 11 11 11 11 11 11 15 16 16 16 17 11 15 16 16 16 16 16 17 11 11 11 11 11 11 11 11 4 9 9 9 9 9 9 9 
11 11 11 11 11 11 11 11 11 11 11 11 11 11 11 11 11 11 15 16 16 14 14 14 14 14 16 14 14 14 14 14 14 14 16 17 11 11 11 11 11 11 4 9 9 9 9 9 9 9 
11 11 11 11 11 11 11 11 11 11 11 11 11 11 11 11 11 15 14 14 14 14 14 14 14 14 14 14 14 14 14 14 14 14 14 14 17 11 11 11 11 11 4 9 9 9 9 9 9 9 
11 11 11 11 11 11 11 11 11 11 11 11 11 11 15 16 16 14 14 14 14 14 14 14 14 14 14 14 14 14 14 14 14 14 14 14 22 11 11 11 11 11 6 9 9 9 9 9 9 9 
11 11 11 11 11 11 11 11 11 11 11 11 11 15 14 14 14 14 14 14 14 14 21 14 14 14 14 14 14 14 14 14 14 14 14 19 11 11 11 11 11 11 11 4 9 9 9 9 9 9 
11 11 11 11 11 11 11 11 11 11 11 11 11 18 14 14 14 14 14 14 14 22 11 20 14 14 14 14 14 14 14 21 21 14 14 19 11 11 11 11 11 11 11 4 9 9 9 9 9 9 
3 11 11 11 11 11 11 11 11 11 11 11 15 14 14 14 14 14 14 14 19 11 11 11 18 14 14 14 14 14 22 11 11 20 21 22 11 11 11 11 11 11 11 6 9 9 9 9 9 9 
9 2 3 11 1 2 3 11 11 11 11 11 18 14 14 14 14 14 14 21 22 11 11 15 14 14 14 21 21 22 11 11 11 11 11 11 11 11 11 11 11 11 11 11 4 9 9 9 9 9 
9 9 9 2 9 9 9 11 11 11 11 11 20 21 21 14 14 21 22 11 11 11 11 18 14 14 22 11 11 11 11 11 11 11 11 11 11 11 11 11 11 11 11 11 6 7 9 9 9 9 
9 9 9 9 9 9 9 11 11 11 11 11 11 11 11 20 22 11 11 11 11 11 11 20 21 22 11 11 11 11 11 11 11 11 11 11 11 11 11 11 11 11 11 11 11 11 4 9 9 9 
9 9 9 9 9 9 5 11 11 11 11 11 11 11 11 11 11 11 11 11 11 11 11 11 11 11 11 11 11 11 11 11 11 11 11 11 11 11 11 11 11 11 11 11 11 11 6 7 7 8 
9 9 9 9 9 9 9 3 11 11 11 11 11 11 11 11 11 11 11 11 11 11 11 11 11 11 11 11 11 11 11 11 11 11 11 11 11 11 11 11 11 15 16 16 17 11 12 11 11 11 
9 9 9 9 9 9 9 5 11 11 11 11 11 11 11 11 11 11 11 11 11 11 11 11 11 11 11 11 11 11 11 11 11 11 11 11 11 11 11 11 15 14 14 14 14 16 17 11 11 11 
9 9 9 9 9 9 9 5 11 11 11 11 11 11 11 11 11 11 11 11 11 11 11 11 11 11 11 11 11 11 11 11 11 11 11 11 11 11 11 11 18 14 14 14 14 14 19 11 11 11 
9 9 9 9 9 9 9 8 11 11 11 11 11 12 11 11 11 11 11 11 11 11 11 11 11 11 11 11 11 11 11 11 11 11 11 11 11 11 11 11 18 14 14 14 14 14 14 17 11 11 
9 9 9 9 9 9 8 11 11 11 11 11 11 11 11 11 11 11 11 11 11 11 11 11 11 11 11 11 11 11 11 11 11 11 11 11 11 11 11 11 20 14 14 14 14 14 14 19 11 11 
9 9 9 9 8 11 11 11 11 11 11 11 11 11 11 11 15 16 16 17 15 16 17 11 11 11 11 11 11 11 11 11 11 11 15 16 16 11 11 11 11 18 14 14 14 14 14 19 11 11 
9 9 9 5 11 11 11 11 11 11 11 11 11 11 11 11 18 14 14 14 14 14 14 17 11 11 11 11 11 11 11 11 11 11 18 14 14 17 11 11 15 14 14 14 14 14 14 19 11 11 
9 9 9 8 11 11 11 11 15 16 16 17 11 11 11 15 14 14 14 14 14 14 14 19 11 11 11 11 11 11 11 11 11 15 14 14 14 14 16 16 14 14 14 14 14 14 14 22 11 11 
7 7 8 11 11 11 11 15 14 14 14 14 16 16 16 14 14 14 14 14 14 14 14 19 11 11 11 11 11 11 11 11 11 18 14 14 14 14 14 14 14 14 14 14 14 14 14 17 11 11 
11 11 11 11 15 16 16 14 14 14 14 14 14 14 14 14 14 14 14 14 14 14 14 22 11 11 11 11 11 11 11 11 11 20 14 14 14 14 14 14 14 14 14 14 14 14 14 19 11 11 
11 11 11 15 14 14 14 14 14 14 14 14 14 14 14 14 14 14 14 14 14 14 19 11 11 11 11 11 11 11 11 11 11 11 18 14 14 14 14 14 14 14 14 14 14 21 21 22 11 11 
11 11 11 18 14 14 14 14 14 14 14 14 14 14 14 14 14 14 14 14 14 14 14 17 11 11 11 11 11 11 11 11 11 11 20 21 14 14 21 14 14 14 21 21 22 11 11 11 11 11 
11 11 11 18 14 14 14 14 14 21 21 14 14 14 14 21 21 14 14 21 14 14 14 19 11 11 11 11 11 11 11 11 11 11 11 11 20 22 12 20 21 22 11 11 11 11 11 11 11 11 
11 11 11 20 14 14 14 14 22 11 11 18 14 21 22 11 11 20 22 11 20 21 21 22 11 11 11 11 11 11 11 11 11 1 2 2 3 11 11 11 11 11 11 11 11 11 11 11 11 11 
11 11 11 11 20 21 21 22 11 11 11 20 22 11 11 11 11 11 11 11 11 11 11 11 11 11 11 11 11 11 1 2 2 9 9 9 9 2 2 2 3 11 11 11 11 11 11 11 11 11 
11 11 11 11 11 11 11 11 11 11 11 11 11 11 11 11 11 11 11 11 11 11 11 11 11 11 11 11 1 2 9 9 9 9 9 9 9 9 9 9 9 2 2 3 11 11 11 11 11 11