50 28
5 5 5 5 5 5 5 5 5 5 5 5 5 5 5 5 5 5 5 5 36 38 38 38 38 38 38 32 5 5 5 5 5 5 5 5 5 5 5 5 5 5 5 5 5 5 5 5 5 5 
5 5 5 5 5 5 5 5 5 5 5 5 5 5 5 5 5 5 5 30 38 38 38 38 38 38 38 37 5 5 5 5 5 5 5 5 5 5 5 5 5 5 5 5 5 5 5 5 5 5 
5 5 5 5 5 5 5 5 5 5 5 5 41 5 5 5 5 5 30 38 38 38 38 38 38 38 38 38 32 5 5 5 5 5 5 5 5 5 5 7 7 5 5 5 5 5 41 5 5 5 
5 5 5 5 5 7 5 5 5 5 5 41 5 5 5 5 5 5 36 38 38 38 38 38 38 38 38 38 38 32 5 5 5 5 5 5 5 5 5 5 7 5 5 5 5 5 5 5 5 5 
5 5 5 5 8 5 5 5 5 5 5 5 5 5 5 5 5 30 38 38 38 38 38 38 38 38 38 38 38 38 32 5 5 5 5 5 5 5 5 5 5 5 5 5 5 5 5 5 5 5 
5 5 5 5 5 5 7 5 5 5 5 5 5 5 5 30 31 38 38 38 38 38 38 38 38 38 38 38 38 38 38 31 32 5 5 5 5 5 5 5 5 5 5 5 5 8 5 5 5 5 
5 5 5 5 7 5 5 5 5 5 5 5 5 30 31 38 38 38 38 38 38 38 38 38 38 38 39 38 38 38 38 38 38 31 32 30 31 32 5 5 5 5 5 5 5 5 5 5 41 5 
5 5 5 5 5 5 5 5 5 5 30 31 31 38 38 38 38 38 38 39 38 38 38 38 38 38 38 38 38 38 38 38 38 38 38 38 38 38 32 5 5 5 5 5 8 5 5 5 5 5 
5 5 5 5 5 5 5 5 5 30 38 38 38 38 38 38 38 38 38 38 38 38 34 34 38 38 38 38 38 38 38 38 38 38 38 38 38 38 37 5 5 5 5 5 5 5 5 5 5 5 
5 5 5 5 5 5 30 31 31 38 38 38 39 38 38 38 38 38 34 34 34 35 5 5 33 34 35 33 34 38 38 39 38 38 38 38 38 38 38 32 5 5 5 5 5 5 5 5 5 5 
31 32 5 5 30 31 38 38 38 38 38 38 38 38 38 38 34 35 5 5 5 5 5 5 5 5 5 5 5 33 34 34 38 38 38 38 38 38 38 38 31 31 32 5 5 5 5 5 5 5 
38 38 31 31 38 38 38 39 38 38 38 38 38 38 38 35 5 5 5 5 5 5 11 12 12 13 5 5 5 5 8 5 33 38 38 38 38 38 38 38 38 38 38 31 31 32 30 31 32 5 
38 38 38 38 38 38 38 38 38 38 38 38 38 34 35 5 5 5 5 11 12 12 9 9 9 9 12 13 5 5 5 8 5 33 34 38 38 38 38 38 39 39 38 38 38 38 38 38 38 32 
38 38 38 38 38 38 38 38 38 38 38 38 35 5 5 5 5 5 11 10 10 10 10 10 10 10 10 10 12 13 5 5 5 7 5 33 38 38 38 38 38 38 38 38 38 38 38 38 38 38 
38 38 38 38 38 38 38 38 38 38 38 35 5 5 8 5 11 12 10 10 10 10 10 10 10 10 10 10 10 10 13 5 5 5 5 5 36 38 38 38 38 38 38 38 38 38 38 38 38 38 
38 38 38 38 38 38 38 38 38 38 38 32 5 5 5 5 17 10 10 10 10 10 10 10 10 10 10 10 10 10 10 12 13 5 5 5 33 39 38 38 38 38 38 38 38 38 38 38 38 38 
38 38 38 38 38 38 38 38 38 38 39 37 5 5 7 5 17 10 10 10 10 10 10 10 10 10 10 10 10 10 10 10 18 5 5 5 30 38 38 38 38 38 38 38 38 38 38 39 38 38 
35 33 34 38 38 38 38 38 38 38 38 38 32 5 5 5 14 10 10 10 10 10 10 10 10 10 10 10 10 10 10 10 18 5 5 5 36 38 38 38 38 38 38 38 38 34 34 35 33 35 
5 5 5 33 34 35 36 38 38 38 38 38 37 5 5 5 5 14 10 10 10 10 10 10 10 10 10 10 10 10 9 15 16 5 5 30 38 38 38 38 38 38 38 38 35 5 5 5 5 5 
5 5 5 5 5 5 33 38 38 38 38 38 38 32 5 5 8 5 14 15 10 10 10 10 10 10 10 10 10 15 16 7 5 5 30 38 38 38 38 38 38 38 38 35 5 5 5 5 5 5 
5 5 5 5 5 5 5 33 34 38 38 38 38 38 31 32 5 5 5 5 14 10 9 9 10 10 10 9 16 5 5 5 5 30 38 38 38 38 38 38 38 38 37 5 5 5 5 5 5 5 
5 41 5 5 5 5 5 5 5 33 38 38 38 38 38 38 32 5 5 5 5 14 15 15 16 14 15 16 5 5 5 30 31 38 38 38 38 38 38 38 38 34 35 5 5 5 5 5 7 5 
5 5 5 5 5 5 5 5 5 5 33 34 38 38 38 38 38 31 31 32 5 5 5 5 5 5 5 5 5 30 31 38 38 38 38 38 38 38 38 34 35 5 5 5 5 5 5 5 5 5 
5 7 5 5 5 7 5 5 5 5 5 5 33 38 38 38 38 38 38 38 32 5 5 30 31 32 5 5 30 38 38 38 38 38 38 35 33 34 35 5 5 5 5 5 5 5 5 5 5 5 
5 5 5 7 5 5 5 5 5 5 5 5 5 36 38 38 38 38 38 38 38 31 31 39 39 38 31 31 38 38 38 38 34 34 35 5 5 5 5 5 5 5 41 5 5 5 7 5 5 5 
5 5 5 5 7 5 5 5 5 5 5 5 5 33 34 34 38 38 38 38 38 38 38 38 38 38 38 38 38 34 34 35 5 5 5 5 5 5 5 5 5 5 5 5 5 41 5 5 5 5 
5 5 7 5 7 5 7 5 5 5 5 5 5 5 5 5 33 34 38 38 38 38 38 38 38 38 38 38 35 5 5 5 5 5 5 5 5 5 5 5 5 7 5 5 5 5 5 5 5 5 
5 5 5 5 5 5 5 5 5 5 5 5 5 5 5 5 5 5 33 38 38 38 38 38 38 38 38 35 5 5 5 5 5 5 5 5 5 5 5 5 5 5 5 5 5 5 5 5 5 5