2
50 28
25 26 26 26 30 16 16 16 16 16 16 16 16 16 16 16 16 16 16 16 16 16 16 16 16 16 16 16 16 16 16 16 16 16 16 16 16 16 16 16 16 16 16 16 16 16 16 16 16 16 
1 25 26 26 26 35 16 16 16 16 16 16 16 16 29 17 22 17 22 30 16 16 16 16 16 16 16 16 16 16 16 16 16 16 16 16 16 16 16 16 16 16 16 16 16 16 16 16 16 16 
1 1 25 26 26 35 16 16 16 16 16 16 16 16 27 18 19 18 19 26 16 16 16 16 16 16 16 16 16 16 16 16 16 16 16 16 16 16 16 16 16 16 16 16 16 16 16 16 16 16 
1 3 1 25 26 35 16 16 16 29 17 22 30 55 27 18 19 18 20 26 30 16 16 16 16 16 16 16 16 16 16 16 16 16 16 16 16 16 16 16 16 16 16 16 16 16 16 16 16 16 
1 1 1 1 1 35 16 16 36 27 18 19 26 1 25 23 24 23 24 28 26 30 16 16 16 16 16 16 16 16 16 16 16 16 16 29 17 22 30 16 16 16 16 16 16 16 16 16 16 16 
2 1 1 1 1 35 16 16 36 27 18 19 26 1 1 1 1 1 1 1 26 26 30 16 16 16 16 16 16 16 16 29 17 22 30 27 18 19 26 30 17 22 30 16 16 16 16 16 16 16 
1 1 1 1 1 35 16 16 36 25 23 24 28 1 1 1 1 2 1 1 26 26 26 30 16 16 16 16 16 16 29 27 18 19 26 27 20 20 26 27 18 19 26 30 16 16 16 16 16 16 
1 1 1 3 1 35 16 16 36 1 1 1 1 1 1 2 1 1 1 1 25 26 26 26 30 16 16 16 16 29 27 27 20 20 26 25 23 24 28 27 20 20 26 26 30 16 16 16 16 16 
1 1 1 1 1 35 16 16 36 1 1 2 1 1 1 1 1 1 1 1 1 25 26 26 26 35 16 16 16 27 27 25 23 24 28 2 1 1 1 25 23 24 28 26 26 30 16 16 16 16 
37 1 1 1 1 35 16 16 36 1 1 1 1 1 1 1 1 1 1 1 1 1 25 26 26 35 16 16 36 27 28 2 1 1 1 1 1 3 1 1 1 1 1 25 26 26 30 16 16 16 
36 1 1 1 1 35 16 16 36 1 1 1 1 1 1 39 16 37 1 1 1 1 1 25 26 35 16 16 36 28 1 1 1 1 1 1 1 1 1 1 1 1 1 1 25 26 26 35 16 16 
36 1 1 1 1 30 16 16 29 1 1 1 1 1 39 16 16 36 1 1 1 1 1 1 1 35 16 16 36 1 1 1 1 2 1 1 38 38 1 1 1 1 1 2 1 25 26 35 16 16 
36 1 1 1 1 26 30 29 27 1 1 1 1 1 35 16 16 16 37 1 1 2 1 1 1 30 16 16 29 1 1 1 1 1 1 39 16 16 37 1 1 1 1 1 3 1 25 35 16 16 
36 1 2 1 1 26 26 27 27 1 1 1 1 1 35 16 16 16 36 1 1 1 1 1 2 26 30 29 27 1 1 1 1 1 39 16 16 16 16 37 1 1 1 1 1 1 1 35 16 16 
36 1 1 1 1 26 26 27 28 1 1 2 1 1 35 16 16 16 36 1 1 1 1 1 1 26 26 27 27 1 1 1 1 1 35 16 16 16 16 36 1 1 1 1 1 1 2 35 16 16 
16 37 1 1 1 25 26 28 1 2 1 1 1 1 35 16 16 16 36 1 1 1 1 1 1 26 26 27 28 1 1 1 1 1 35 16 16 16 16 16 37 1 1 1 1 1 1 35 16 16 
16 36 1 1 1 1 1 1 1 1 1 1 1 1 35 16 16 16 36 1 1 1 1 1 1 25 26 28 1 1 1 1 1 1 35 16 16 16 16 16 36 1 1 1 1 1 1 35 16 16 
16 36 1 1 2 1 1 1 1 1 1 1 1 1 35 16 16 16 36 1 1 3 1 1 1 1 1 1 1 1 1 1 1 1 35 16 16 16 16 16 36 1 1 1 1 2 1 35 16 16 
16 36 1 1 1 1 1 1 1 1 1 1 1 39 16 16 16 16 36 1 1 1 1 1 1 1 1 1 1 1 1 1 1 1 35 16 16 16 16 16 36 2 1 1 1 1 1 30 29 27 
16 16 37 1 1 1 1 1 1 3 1 2 1 35 16 16 16 16 36 1 1 1 1 1 1 1 1 1 1 3 1 1 1 1 35 16 16 16 16 16 36 1 1 1 1 1 2 26 27 27 
16 16 36 1 1 1 1 1 1 1 1 38 39 16 16 16 16 16 36 1 1 1 1 1 1 1 1 2 1 1 1 1 1 1 35 16 16 16 16 16 36 1 1 1 1 1 1 26 27 27 
16 16 16 37 1 1 2 1 1 1 39 16 16 16 16 16 16 16 36 1 1 1 2 1 1 1 1 1 1 1 1 1 2 1 35 16 16 16 16 16 36 3 1 1 1 1 1 26 27 28 
16 16 16 16 37 38 38 38 38 39 16 16 16 16 16 16 16 16 16 37 1 1 1 1 1 1 1 1 1 1 1 1 1 39 16 16 16 16 16 16 36 1 2 1 1 1 1 1 1 1 
16 16 16 16 16 16 16 16 16 16 16 16 16 16 16 16 16 16 16 16 37 1 1 1 1 1 1 3 1 2 1 1 39 16 16 16 16 16 16 16 16 37 1 1 1 1 1 1 1 1 
16 16 16 16 16 16 16 16 16 16 16 16 16 16 16 16 16 16 16 16 16 37 38 38 1 1 1 1 1 1 1 39 16 16 16 16 16 16 16 16 16 36 1 1 1 1 1 1 3 1 
16 16 16 16 16 16 16 16 16 16 16 16 16 16 16 16 16 16 16 16 16 16 16 16 37 38 38 38 38 38 39 16 16 16 16 16 16 16 16 16 16 16 37 1 1 1 1 1 1 1 
16 16 16 16 16 16 16 16 16 16 16 16 16 16 16 16 16 16 16 16 16 16 16 16 16 16 16 16 16 16 16 16 16 16 16 16 16 16 16 16 16 16 16 37 1 1 1 1 1 1 
16 16 16 16 16 16 16 16 16 16 16 16 16 16 16 16 16 16 16 16 16 16 16 16 16 16 16 16 16 16 16 16 16 16 16 16 16 16 16 16 16 16 16 16 37 2 1 1 1 1