0
50 28
1 1 1 1 1 1 1 1 1 3 1 1 1 1 1 1 1 1 1 1 1 1 1 3 1 1 1 55 1 1 3 1 3 1 3 1 3 1 13 5 5 5 5 5 5 5 5 5 5 5 
1 1 1 1 1 1 1 1 1 1 1 1 1 1 1 1 1 1 1 1 1 1 3 1 3 1 1 59 55 1 3 1 3 3 1 3 1 7 5 5 5 5 5 5 5 5 5 5 5 5 
1 1 1 1 1 1 1 1 3 1 1 1 37 1 1 3 1 1 1 1 1 3 1 3 3 1 1 1 59 54 54 55 1 1 1 1 7 5 5 5 5 5 5 5 5 5 5 5 5 5 
1 1 1 1 1 1 1 1 1 1 1 1 1 1 1 3 1 1 1 37 1 1 1 1 1 37 1 1 1 1 1 59 54 55 3 1 13 5 5 5 5 5 5 5 5 5 5 5 5 12 
1 1 1 1 1 1 1 1 1 1 1 1 1 1 1 1 1 1 1 1 1 1 1 1 1 1 3 1 1 1 1 36 36 59 55 1 10 5 5 5 5 5 5 5 11 11 6 6 14 1 
1 1 1 1 1 1 1 1 1 1 1 3 1 1 1 1 1 37 1 1 1 1 1 1 1 1 1 3 1 3 1 1 36 36 52 1 1 13 5 5 5 5 5 12 1 3 10 11 12 1 
3 3 1 1 1 3 1 1 1 1 1 1 1 1 1 1 1 1 1 1 1 1 1 1 1 1 3 1 3 1 1 36 1 36 52 3 1 13 5 5 5 5 14 1 1 1 1 1 53 54 
1 3 1 3 1 1 1 1 1 1 1 1 1 1 1 1 1 1 1 1 1 1 37 1 1 1 1 3 1 3 1 57 46 46 47 1 1 13 5 5 5 5 12 1 53 54 54 54 58 1 
3 1 3 1 1 1 1 1 1 3 1 1 1 1 1 1 1 1 1 1 1 1 1 1 1 1 1 57 46 46 46 47 49 49 50 1 7 5 5 5 5 12 1 53 58 1 3 1 3 3 
46 46 46 46 46 56 1 1 1 1 1 1 42 18 18 18 41 1 1 1 1 57 46 46 46 46 46 47 49 49 49 50 1 3 1 7 5 6 5 5 14 1 1 41 1 3 1 3 1 1 
48 49 49 49 49 45 46 46 56 1 1 1 52 16 16 16 51 1 1 57 46 47 49 49 49 49 49 50 1 1 1 1 3 1 7 5 6 6 5 5 12 1 1 51 1 1 3 1 1 3 
1 1 1 1 1 48 49 49 45 46 46 46 47 17 17 17 45 46 46 47 49 50 1 1 1 1 3 1 1 1 1 3 1 7 5 5 6 5 5 12 53 54 54 58 1 1 1 1 3 1 
1 1 1 1 1 1 1 1 48 49 49 49 50 17 17 17 48 49 49 50 1 1 1 1 1 1 1 1 3 1 7 8 8 5 5 5 6 11 12 53 58 1 1 1 1 4 1 3 1 3 
8 9 1 1 1 7 8 9 1 1 1 1 7 5 5 5 9 1 1 1 1 3 1 1 3 1 1 1 1 7 5 5 5 5 6 6 12 1 1 51 1 1 1 1 1 1 1 3 3 1 
5 6 8 8 8 5 5 5 8 8 8 8 5 5 5 6 5 8 9 1 1 1 1 1 1 1 1 1 1 13 5 5 5 5 6 14 1 1 53 58 1 1 1 1 1 3 3 1 1 3 
5 5 6 6 5 6 6 5 5 6 5 5 5 5 5 5 5 5 14 1 1 1 1 1 1 1 1 1 7 5 5 5 5 5 11 12 3 1 51 1 1 1 1 1 1 1 1 1 4 3 
5 5 5 5 6 5 5 5 5 5 5 5 5 6 5 6 6 5 5 9 1 1 7 8 8 8 8 5 5 5 5 5 5 12 1 1 1 1 51 1 1 1 36 1 4 3 3 1 1 1 
5 11 11 5 5 11 11 12 10 11 11 11 5 5 5 5 6 6 5 5 8 8 5 5 6 5 5 5 5 5 5 5 12 1 1 1 1 53 58 36 1 1 1 1 1 1 3 3 1 1 
12 1 3 10 12 1 1 1 1 1 3 1 10 12 10 5 5 5 6 5 5 5 5 5 11 11 11 5 5 5 5 12 1 1 3 1 53 58 1 1 1 1 1 1 1 1 1 1 1 1 
1 3 1 1 3 1 3 1 3 1 1 38 38 38 38 10 5 5 5 5 5 5 11 12 1 1 1 10 5 5 14 1 1 1 1 1 51 1 1 1 1 1 1 36 1 1 1 1 36 1 
1 1 1 3 1 1 1 26 27 28 1 1 1 3 40 1 13 5 5 5 5 12 1 1 3 3 1 1 13 5 14 1 1 1 1 1 51 1 1 1 1 1 1 1 1 1 1 1 1 1 
3 1 26 27 27 28 26 34 34 34 27 27 28 1 40 1 10 5 5 5 14 1 37 37 3 3 4 1 13 5 14 1 1 1 1 1 45 46 46 46 46 56 1 1 1 1 1 1 1 1 
1 1 32 35 34 34 34 34 34 34 34 34 33 1 40 1 1 13 6 5 5 9 1 1 1 4 1 1 13 5 5 9 1 1 1 1 48 49 49 49 49 45 46 46 56 1 1 1 1 1 
1 26 34 34 34 34 34 34 34 34 35 34 33 1 40 1 1 10 11 5 5 5 9 1 37 1 1 7 5 5 5 5 9 1 1 1 1 1 1 1 1 48 49 49 45 46 46 56 1 36 
1 29 30 34 34 34 35 34 34 34 34 34 31 1 3 1 1 1 1 10 5 5 5 8 8 8 8 5 5 5 5 5 5 8 8 8 9 1 1 1 1 1 1 1 48 49 49 45 46 46 
1 3 1 29 30 34 34 34 34 34 30 31 1 1 1 1 1 1 1 1 10 5 5 5 5 5 5 11 11 5 5 5 5 5 5 5 5 8 8 9 1 7 8 8 9 1 1 48 49 49 
1 3 3 3 1 29 30 30 30 31 1 3 1 3 3 1 3 1 1 1 1 10 11 11 11 11 12 1 1 10 11 11 5 5 5 5 5 5 5 5 8 5 5 5 5 8 8 8 8 8 
1 1 1 1 1 1 1 1 1 1 1 1 1 3 1 1 1 1 1 1 1 1 1 1 1 1 1 1 1 1 1 1 10 5 5 6 5 5 5 5 5 5 5 5 5 5 5 5 5 5