50 28
1 38 1 1 1 4 1 1 1 1 1 3 1 1 1 1 1 1 1 1 1 1 10 6 6 6 6 6 6 5 5 5 5 5 5 5 6 12 1 1 1 1 1 1 1 1 1 1 1 1 
8 8 9 37 1 1 1 1 36 1 1 1 1 1 26 28 1 1 36 1 1 1 2 6 6 6 6 6 6 5 5 5 5 5 11 11 12 1 1 1 1 1 26 27 27 28 2 2 1 1 
11 5 5 8 8 9 1 1 1 1 1 7 9 1 32 34 27 28 1 1 1 1 1 10 6 6 6 6 6 5 5 5 5 12 2 3 1 1 1 1 1 26 34 34 34 33 2 3 1 1 
1 10 5 6 5 14 1 1 3 1 7 5 14 1 32 35 34 33 1 1 1 1 1 1 10 6 6 6 6 5 5 6 12 1 1 1 1 1 1 1 1 32 34 35 34 34 28 1 1 1 
1 1 13 5 6 6 8 9 1 7 6 5 6 9 29 34 34 33 1 1 1 1 1 1 2 13 6 6 5 5 6 6 2 1 1 1 1 1 1 1 26 34 34 34 34 34 33 1 1 1 
1 1 13 5 5 5 5 14 1 13 5 5 6 12 1 32 34 35 28 1 1 1 1 1 7 6 6 6 5 5 6 14 1 1 1 1 1 1 3 1 32 34 35 34 34 34 31 1 1 1 
1 1 10 11 11 5 5 5 8 5 6 5 14 40 1 32 34 34 33 3 1 1 1 1 13 6 6 5 6 5 6 12 1 1 1 37 1 1 1 1 32 34 34 34 34 33 1 1 3 1 
1 3 1 1 1 10 5 5 5 5 5 6 14 1 26 35 34 34 33 1 1 1 1 1 10 6 5 5 5 5 14 1 1 1 1 1 1 1 1 1 29 34 34 34 34 31 1 1 1 1 
2 1 2 1 37 1 13 6 5 6 5 5 5 9 29 30 30 30 31 1 1 1 1 1 1 10 5 5 5 6 14 1 3 1 1 1 1 1 1 26 27 34 34 34 33 1 1 1 1 1 
1 1 1 1 1 7 5 5 5 5 6 5 5 5 8 8 9 1 1 36 1 1 1 1 1 2 13 5 5 6 6 9 1 1 1 1 1 1 1 29 30 34 34 35 33 1 1 1 1 1 
1 39 7 8 8 5 5 11 5 5 5 5 6 6 5 5 14 1 1 1 1 1 1 1 1 7 5 5 5 5 5 6 8 9 1 1 1 37 1 1 2 29 30 30 31 1 1 1 1 1 
1 7 6 5 5 11 12 1 10 11 5 5 5 5 5 5 14 1 3 1 1 1 1 1 7 5 5 5 5 5 5 5 5 5 9 1 1 37 2 7 8 9 1 1 1 1 3 1 1 1 
1 13 5 5 14 1 1 1 1 1 10 5 5 5 5 6 5 9 38 1 1 1 1 7 5 5 5 5 5 5 5 5 5 5 6 6 8 8 6 6 6 6 9 1 1 1 1 1 2 2 
1 10 11 11 12 1 36 1 1 1 3 51 3 1 1 5 5 5 8 9 7 8 8 5 5 5 5 5 5 5 5 5 5 5 5 6 11 11 11 6 6 6 6 9 1 1 1 7 8 8 
4 1 1 1 1 1 1 1 1 1 2 43 1 1 3 1 5 11 6 6 5 5 5 5 5 5 5 5 5 5 5 5 6 5 5 12 1 1 1 10 6 6 6 6 8 9 7 5 5 5 
1 1 1 1 1 1 1 1 1 1 1 2 2 2 2 2 42 1 10 6 5 5 5 5 5 5 5 5 5 5 5 5 6 5 14 1 1 1 1 1 10 6 6 6 6 6 5 5 5 5 
1 1 1 1 1 1 1 1 1 1 2 1 1 1 2 1 1 1 1 13 6 5 5 5 5 5 5 5 5 5 6 5 5 5 14 1 1 1 1 1 2 10 6 6 6 5 5 5 5 6 
1 1 1 1 1 1 1 1 1 1 1 1 1 1 2 2 3 1 1 10 6 6 5 5 5 5 5 5 5 5 5 5 5 6 14 1 1 1 1 1 1 2 11 11 6 6 6 6 6 6 
1 1 1 2 3 1 1 1 1 1 1 1 1 1 1 1 1 1 1 1 13 6 5 6 5 5 5 5 5 5 5 5 5 5 6 9 1 1 1 1 1 1 1 1 10 11 6 6 6 6 
1 1 37 1 1 1 2 38 38 38 38 2 2 3 2 1 1 1 1 1 13 6 5 5 5 5 5 5 5 5 5 5 5 5 6 12 1 1 1 1 1 1 37 1 1 1 10 6 6 6 
2 37 1 1 1 1 2 2 2 2 3 2 2 2 40 1 1 1 1 1 10 6 6 5 5 5 5 5 5 5 5 5 5 6 12 1 1 1 1 1 1 1 37 1 1 1 1 10 11 6 
1 1 1 1 1 26 27 28 3 26 27 27 28 3 40 1 1 1 1 1 1 10 6 6 5 5 5 5 5 5 5 5 5 11 9 1 1 1 1 2 2 37 2 37 1 1 2 2 2 10 
1 1 1 1 26 34 34 34 27 34 34 34 34 28 40 2 1 1 1 1 1 1 13 6 6 5 5 5 5 5 5 5 12 1 1 1 1 1 1 1 1 1 1 1 1 1 1 36 2 2 
1 1 1 1 32 34 34 35 34 34 34 35 34 33 2 2 1 1 1 1 1 1 10 6 6 5 5 5 5 5 5 12 2 3 1 1 1 1 1 1 2 2 2 3 1 1 1 1 1 2 
37 1 1 1 29 34 34 34 34 34 34 30 30 31 40 1 1 37 1 1 1 1 1 13 6 6 6 6 6 6 14 2 2 1 1 1 1 2 4 2 4 2 3 3 3 53 54 54 55 1 
1 1 1 1 2 32 34 34 34 30 31 2 1 1 1 1 1 1 1 1 1 1 7 6 6 6 6 6 6 6 6 9 2 1 2 37 2 4 4 4 4 2 3 3 53 43 3 2 2 55 
1 1 1 1 1 29 30 30 31 2 1 1 1 1 1 1 1 1 1 1 1 7 6 6 6 6 6 6 6 6 6 14 1 1 2 2 2 2 4 4 4 4 2 53 3 51 2 53 54 52 
1 1 1 1 1 1 1 1 1 1 1 1 1 1 1 1 1 1 1 1 2 13 6 6 6 6 6 6 6 6 6 12 2 2 2 2 2 2 4 4 4 4 2 51 2 41 2 45 2 2